awesome - приголомшливий
candle - свічка
come true - здійснитися
crowded - багатолюдний
cute - милий
date - побачення
decoration - прикраса
dream - мрія
entertain - розважати
excellent - відмінний
fancy - модний
festival - фестиваль
firework - феєрверк
flower - квітка
gift - подарунок
greeting card - листівка
guest - гість
happiness - щастя
have a drink - випити
have a meal - з’їсти
have an idea - мати ідею
have fun - весело проводити час
have rest - відпочивати
have time - проводити час
invitation - запрошення
kiss - поцілунок
noisy - галасливий
romantic - романтичний
together - разом
traditional - традиційний